111111111011
1C10000000001
1000111111001
1P00111001001
1111111111111

