1111111111111
1C10000000001
1000111111001
1P00111E00001
1111111111111

