1111111111111
101000000M0C1
101000C00C001
1010000000001
1000111111C11
1P001E0000001
1111111111111