





1111111111111
10010010000C1
100001 111001
1P00111000001
1111111111111

