1111111111111
1000M0000M0C1
100000C000001
1000M0000M001
1000000C00001
1P000E0000001
1111111111111