1111111111111
10100000000C1
1000111111011
10001E0000001
1111111111111