1111111111111
1000M0000M0C1
1000010000001
100010100M001
1000010000001
1P000E0000001
1111111111111