




1111111111111
10100000000C1
1000111111011
1P00010E00001
1111111111111




