1111111111111
1010000000001
10000000000C1
1010000000001
1000111111011
1P001E0000001
1111111111111