1111111111111
100000000M0C1
100MMMC000001
100MM0000M001
1000000C00001
1P000E0M00001
1111111111111