1111111111
11100010C1
1P01000001
10000101E1
1111111111
