0P00000000000000
0011100000000000
00110001C1000110
00000111111100E0
0000000000000000
