1111111111111111
1P11100000000001
10110001C1000110
10000111111100E1
1111111111111111
