1111111111111111111111
1P00000000000000000001
1000000000000000000001
1000000110000011100001
1000001M10000100010001
1000010010000000010001
10001M0M10000000100001
1000011110000001000001
1000000010000010000001
1000000010000111110001
1000000000000000000001
1C000000000000000000E1
1111111111111111111111
