111111111111111111111111111111
1PMMCMMMCM0M0M0MCM0M0MCM0M0ME1
111111111111111111111111111111
