111111111111111111111111
1CM001000M000M0M01100M01
1000011000000P0001000M01
1000M011C0M010M1010MC001
100MEM0100000M0100001C01
1000M0100M0M000M0M000111
10M0011100M00M00000M0001
1000011100M00000M0M00011
10M0000M0000100M000M0111
1000M001C0M111C1000M0011
11CM00111C1111100M00C111
111111111111111111111111
