111111111111111111111111
100000110000110001100001
1000000110M0001001100001
1000E01010000001100C0001
100001001111000110010001
100011000001001100011101
100000100000000000011111
110110001000P01000000111
100000000000001010000001
10M100011100001000M00011
111100100C00000000000111
100001000000011100011111
1000000011111100000C0001
100001000011000000000001
10000C10000000011100M001
111111111111111111111111
