111111111111111111111111
1000010000000M0001100001
1000011000000P0001000001
10000011C00010010100C001
1000E0010000000100001C01
100000100M00000000000111
100001110000000000000001
100001110000000000M00011
100000000000100000000111
1000M001C001110100000011
110000111011111000000111
111111111111111111111111
