1111111111111
1C01000000001
1101000000001
10010P0001101
101100001M101
1C00000011CE1
1111111111111
