11111111111111111111111111111111111
1P100100000001111100010001000000001
1010110101100C100001100101001111001
100000010C11000011000010000011E00001
11111111111111111111111111111111111
