1111111111111111
1P111000000000E1
10110001C1000111
10000111111100E1
1111111111111111
