1111111111111111
1P11100000000001
1011000101000111
10000111111100E1
1111111111111111
