1111111111111111
1P11100000000001
10110001C1000111
1000011111110001
1111111111111111
