1111111111111111
10111000000000C1
1011000101000111
10000111C11100E1
1111111111111111
