1111111111111111
1P111000000100C1
1011000101001111
10000111C11000E1
1111111111111111
