1111111111111111
1P111000000000C1
1011100101000111
10000111C11100E1
1111111111111111
